###########
##...#.@.##
###..##..##
#..#..#...#
#...#.#.###
###.......#
#.###....##
#.......###
###..#...##
#.....##..#
###########