###########
#.........#
#.###.###.#
#.#.....#.#
#.#.###.#.#
#.#.#@#.#.#
#.#.#.#.#.#
#.#.....#.#
#.#######.#
#.........#
###########