...###
..##...##.#
.##..###..#
##........#
#..#@..#.##
########..#
..#..#....#
.##.##.#.##
.#...#..##
.#.#...##
.#######